00000000
00000000
11211211
11131111
11111111